"filename", "language", "TOML", "Rust", "x86 and x86_64 Assembly", "comment", "blank", "total"
"c:\Users\aldor\Source\repos\Aval-OS\research-os\Aval-OS-R3\Cargo.toml", "TOML", 14, 0, 0, 0, 5, 19
"c:\Users\aldor\Source\repos\Aval-OS\research-os\Aval-OS-R3\bootloader\boot.asm", "x86 and x86_64 Assembly", 0, 0, 12, 3, 3, 18
"c:\Users\aldor\Source\repos\Aval-OS\research-os\Aval-OS-R3\src\GDT.rs", "Rust", 0, 15, 0, 0, 2, 17
"c:\Users\aldor\Source\repos\Aval-OS\research-os\Aval-OS-R3\src\IDT.rs", "Rust", 0, 29, 0, 0, 4, 33
"c:\Users\aldor\Source\repos\Aval-OS\research-os\Aval-OS-R3\src\Message.rs", "Rust", 0, 30, 0, 0, 5, 35
"c:\Users\aldor\Source\repos\Aval-OS\research-os\Aval-OS-R3\src\Process.rs", "Rust", 0, 73, 0, 4, 9, 86
"c:\Users\aldor\Source\repos\Aval-OS\research-os\Aval-OS-R3\src\Scheduler.rs", "Rust", 0, 38, 0, 3, 5, 46
"c:\Users\aldor\Source\repos\Aval-OS\research-os\Aval-OS-R3\src\interrupts.rs", "Rust", 0, 18, 0, 1, 3, 22
"c:\Users\aldor\Source\repos\Aval-OS\research-os\Aval-OS-R3\src\main.rs", "Rust", 0, 54, 0, 3, 9, 66
"c:\Users\aldor\Source\repos\Aval-OS\research-os\Aval-OS-R3\src\memory.rs", "Rust", 0, 22, 0, 0, 3, 25
"c:\Users\aldor\Source\repos\Aval-OS\research-os\Aval-OS-R3\src\panic.rs", "Rust", 0, 9, 0, 0, 1, 10
"c:\Users\aldor\Source\repos\Aval-OS\research-os\Aval-OS-R3\src\serial.rs", "Rust", 0, 13, 0, 0, 3, 16
"Total", "-", 14, 301, 12, 14, 52, 393